###########
#   #   # #
# # ### # #
# #       #
# ##### # #
#     # # #
# ### ### #
# #     # #
##### # # #
#     # # #
###########