###########
# #   #   #
# ### ### #
#         #
# ### #####
#   #     #
# ### #####
# #   #   #
# ### ### #
#   #     #
###########