###########
#         #
### # # # #
#   # # # #
# ##### # #
#     # # #
# #########
#         #
# # # # ###
# # # #   #
###########